1111111111111
1P010000000C1
1E00011111001
100P110000001
1111111111111